11111111111111111111111
1C0000000000000000000C1
11100000001110000000111
11111111111P11111111111
11100000001110000000111
1E0000000000000000000C1
11111111111111111111111
