11111111111111111111111
1C1000000000000000001C1
11100000001110000000111
10000000001P10000000001
11100000001110000000111
1E1000000000000000001C1
11111111111111111111111
