111111111111111111111111
101001010010000010100101
101001001010101010100101
11

100000000C00C00010000001
101001010010000010100101
101001001010101010100101
100000000C00C00010000001
100P00000C00CE0010000001
111111111111111111111111
