11111111111111111111111
110000000000000000000C1
11100000000000000000111
11111111111111111111111
11100000000000000000111
1E00000P0000000000000C1
11111111111111111111111
